감정하다 - appraise
계산하다 - calculate
구별하다 - differentiate
구분하다 - classify, categorize, separate
관찰하다 - examine, inspect
검토하다 - analyze, review
구성하다 - model
구체화하다 - illustrate
귀납하다 - deduce
꼼꼼히 조사하다 - investigate, scrutinize
나열하다 - inventory, outline
논쟁하다 - debate
대조하다 - contrast
도표화하다 - diagram
면밀히 살피다 - inspect, examine
문제를 제기하다 - question
비교하다 - compare
분류하다 - classify, categorize, sort
상관 관계를 분석하다 - correlate
설명하다 - explain
실험하다 - experiment, test
식별하다 - identify, recognize
알아보다 - recognize, identify
연구하다 - research
연결하다 - relate
예시하다 - illustrate
예상하다 - infer
요약하다 - outline
응답하다 - reply (명령형으로 처리할 수 있음)
주목하다 - focus
지적하다 - point out
제한하다 - limit
조사하다 - investigate
추론하다 - deduce
평가하다 - evaluate, appraise
확인하다 - identify, verify