Arrange - 배열하다, 정리하다
Count - 세다
Define - 정의하다
Describe - 설명하다, 묘사하다
Duplicate - 복제하다, 복사하다
Draw - 그리다
Enumerate - 열거하다
Find - 찾다
Identify - 식별하다, 확인하다
Label - 라벨을 붙이다, 명명하다
List - 나열하다, 목록을 작성하다
Match - 일치시키다, 맞추다
Memorize - 암기하다
Name - 이름을 대다, 명명하다
Order - 순서를 매기다, 정렬하다
Outline - 개요를 작성하다
Quote - 인용하다
Read - 읽다
Recall - 회상하다, 기억해내다
Recite - 암송하다
Record - 기록하다
Recognize - 인식하다, 알아보다
Relate - 관련시키다, 연결하다
Repeat - 반복하다
Reproduce - 재생하다, 복제하다
Select - 선택하다
Sequence - 순서를 정하다
State - 진술하다
Tell - 말하다
Underline - 밑줄을 긋다
View - 보다
Write - 쓰다